# Syntax Coloring Map For BasicColorLedControl
# Datatypes	(KEYWORD1)

LedType	KEYWORD1
LedColor	KEYWORD1
BasicColorLedControl	KEYWORD1

# Methods/Functions (KEYWORD2)

setupLEDs	KEYWORD2
setLEDColor	KEYWORD2
unsetLEDs	KEYWORD2
TestLEDs	KEYWORD2

# Constants (LITERAL1)

COMMON_ANODE	LITERAL1
COMMON_CATHODE	LITERAL1
RED	LITERAL1
BLUE	LITERAL1
GREEN	LITERAL1
YELLOW	LITERAL1
CYAN	LITERAL1
MAGENTA	LITERAL1
WHITE	LITERAL1